111111111111111110111
100000000000000000001
100000000000000000001
100000000000000000001
111111111111111111111
