111111111111111111111
1P0000000000000000001
10000E000000000000001
100000000000000C00001
111111111111111111111
