1111111111111111111111111111111111
1E0000000000000C00000C000000000001
1010101110100010001110100010010101
1011101100100010001010110110010101
1010101110111011101110101010010101
1010001101000100000000000000000001
1P0000000C00C0000000000000000000C1
1111111111111111111111111111111111
