1111011111111111
1000000000000001
1000000000000000
0111111111111111
