111111111111111111111
1P00000000000000C0001
100000000000000000001
1000000000C0000C00001
111111111111111111111
