1111111111111111111
111
1111111111111111111
