1111111111111111111
111111100000001
1000000000000000001
1000000000000000001
1111111111111111111
